#SampleID	BarcodeSequence	LinkerPrimerSequence
1Leaf	ACCCATATATCC	GCTGCGTTCTTCATCGATGC
2Leaf	ACCCATAAGACG	GCTGCGTTCTTCATCGATGC
3Leaf	TCGCCAGAACCA	GCTGCGTTCTTCATCGATGC
4Leaf	ACCCATATCAAA	GCTGCGTTCTTCATCGATGC
5Leaf	ACCCATATAGTA	GCTGCGTTCTTCATCGATGC
6Leaf	ACCCATCTACAG	GCTGCGTTCTTCATCGATGC
7Leaf	ACCCATCATACC	GCTGCGTTCTTCATCGATGC
8Leaf	ACCCATCATTAT	GCTGCGTTCTTCATCGATGC
9Leaf	ACCCATCTATCT	GCTGCGTTCTTCATCGATGC
12Leaf	TCGCCAAACTGA	GCTGCGTTCTTCATCGATGC
13Leaf	ACTGATATATCC	GCTGCGTTCTTCATCGATGC
14Leaf	ACTGATAAGACG	GCTGCGTTCTTCATCGATGC
15Leaf	ACTGATAATGAG	GCTGCGTTCTTCATCGATGC
16Leaf	ACTGATATCAAA	GCTGCGTTCTTCATCGATGC
17Leaf	GTGCCTGAACCA	GCTGCGTTCTTCATCGATGC
18Leaf	ACTGATCTACAG	GCTGCGTTCTTCATCGATGC
19Leaf	GGGCGCGAACCA	GCTGCGTTCTTCATCGATGC
20Leaf	ACTGATCATTAT	GCTGCGTTCTTCATCGATGC
21Leaf	ACTGATCTATCT	GCTGCGTTCTTCATCGATGC
22Leaf	CCGCATGAACCA	GCTGCGTTCTTCATCGATGC
23Leaf	GTGCCTAACTGA	GCTGCGTTCTTCATCGATGC
24Leaf	GGGCGCAACTGA	GCTGCGTTCTTCATCGATGC
25Leaf	AATGAGGAACCA	GCTGCGTTCTTCATCGATGC
26Leaf	ATAATTAAGACG	GCTGCGTTCTTCATCGATGC
27Leaf	CCGCATAACTGA	GCTGCGTTCTTCATCGATGC
28Leaf	AATGAGAACTGA	GCTGCGTTCTTCATCGATGC
29Leaf	ATAATTATAGTA	GCTGCGTTCTTCATCGATGC
30Leaf	ATAATTCTACAG	GCTGCGTTCTTCATCGATGC
31Leaf	ACTGGCAACTGA	GCTGCGTTCTTCATCGATGC
32Leaf	ATAATTCATTAT	GCTGCGTTCTTCATCGATGC
33Leaf	ACTGGCGAACCA	GCTGCGTTCTTCATCGATGC
34Leaf	CACCTCAACTGA	GCTGCGTTCTTCATCGATGC
35Leaf	CACCTCGAACCA	GCTGCGTTCTTCATCGATGC
36Leaf	ATAATTGTAAAC	GCTGCGTTCTTCATCGATGC
37Leaf	AGCCATATATCC	GCTGCGTTCTTCATCGATGC
38Leaf	AGCCATGTAAAC	GCTGCGTTCTTCATCGATGC
39Leaf	CGTGATGAACCA	GCTGCGTTCTTCATCGATGC
40Leaf	CGTGATTGCCCG	GCTGCGTTCTTCATCGATGC
41Leaf	TCGCCAAAGACG	GCTGCGTTCTTCATCGATGC
42Leaf	AGCCATCTACAG	GCTGCGTTCTTCATCGATGC
43Leaf	AGCCATCATACC	GCTGCGTTCTTCATCGATGC
44Leaf	TCGCCAGCCGTA	GCTGCGTTCTTCATCGATGC
45Leaf	GTGCCTGCCGTA	GCTGCGTTCTTCATCGATGC
46Leaf	GGGCGCGCCGTA	GCTGCGTTCTTCATCGATGC
47Leaf	AGCCATGTATTT	GCTGCGTTCTTCATCGATGC
48Leaf	AGCCATAAGACG	GCTGCGTTCTTCATCGATGC
49Leaf	CCGCATGCCGTA	GCTGCGTTCTTCATCGATGC
50Leaf	AGTTAAAAGACG	GCTGCGTTCTTCATCGATGC
51Leaf	AGTTAAAATGAG	GCTGCGTTCTTCATCGATGC
52Leaf	GTGCCTAAGACG	GCTGCGTTCTTCATCGATGC
53Leaf	GGGCGCAAGACG	GCTGCGTTCTTCATCGATGC
54Leaf	AGTTAACTACAG	GCTGCGTTCTTCATCGATGC
55Leaf	AGTTAACATACC	GCTGCGTTCTTCATCGATGC
56Leaf	AATGAGGCCGTA	GCTGCGTTCTTCATCGATGC
57Leaf	ACTGGCGCCGTA	GCTGCGTTCTTCATCGATGC
58Leaf	AGTTAACTCACC	GCTGCGTTCTTCATCGATGC
59Leaf	AGTTAAGTATTT	GCTGCGTTCTTCATCGATGC
60Leaf	AGTTAAGTAAAC	GCTGCGTTCTTCATCGATGC
61Leaf	ATCAAAATATCC	GCTGCGTTCTTCATCGATGC
62Leaf	ATCAAAAAGACG	GCTGCGTTCTTCATCGATGC
63Leaf	ATCAAAAATGAG	GCTGCGTTCTTCATCGATGC
64Leaf	ATCAAAATCAAA	GCTGCGTTCTTCATCGATGC
65Leaf	CCGCATAAGACG	GCTGCGTTCTTCATCGATGC
66Leaf	ATCAAACTACAG	GCTGCGTTCTTCATCGATGC
67Leaf	AATGAGAAGACG	GCTGCGTTCTTCATCGATGC
68Leaf	ATCAAACATTAT	GCTGCGTTCTTCATCGATGC
69Leaf	CACCTCGCCGTA	GCTGCGTTCTTCATCGATGC
70Leaf	CGTGATGCCGTA	GCTGCGTTCTTCATCGATGC
71Leaf	ATCAAAGTATTT	GCTGCGTTCTTCATCGATGC
72Leaf	TCGCCAGGGGCG	GCTGCGTTCTTCATCGATGC
73Leaf	GTGCCTGGGGCG	GCTGCGTTCTTCATCGATGC
74Leaf	GGGCGCGGGGCG	GCTGCGTTCTTCATCGATGC
75Leaf	CACCTCAATGAG	GCTGCGTTCTTCATCGATGC
76Leaf	CCGCATGGGGCG	GCTGCGTTCTTCATCGATGC
77Leaf	CACCTCATAGTA	GCTGCGTTCTTCATCGATGC
78Leaf	CACCTCCTACAG	GCTGCGTTCTTCATCGATGC
79Leaf	CACCTCCATACC	GCTGCGTTCTTCATCGATGC
80Leaf	CACCTCCATTAT	GCTGCGTTCTTCATCGATGC
81Leaf	CACCTCCTATCT	GCTGCGTTCTTCATCGATGC
82Leaf	CACCTCCTCACC	GCTGCGTTCTTCATCGATGC
83Leaf	ACTGGCAAGACG	GCTGCGTTCTTCATCGATGC
84Leaf	CACCTCGTAAAC	GCTGCGTTCTTCATCGATGC
85Leaf	CCACATATATCC	GCTGCGTTCTTCATCGATGC
86Leaf	AATGAGGGGGCG	GCTGCGTTCTTCATCGATGC
87Leaf	ACTGGCGGGGCG	GCTGCGTTCTTCATCGATGC
88Leaf	CCACATATCAAA	GCTGCGTTCTTCATCGATGC
89Leaf	CACCTCGGGGCG	GCTGCGTTCTTCATCGATGC
90Leaf	CCACATCTACAG	GCTGCGTTCTTCATCGATGC
91Leaf	CCACATCATACC	GCTGCGTTCTTCATCGATGC
92Leaf	CACCTCAAGACG	GCTGCGTTCTTCATCGATGC
93Leaf	CCACATCTATCT	GCTGCGTTCTTCATCGATGC
94Leaf	CGTGATAAGACG	GCTGCGTTCTTCATCGATGC
95Leaf	TCGCCATGCCCG	GCTGCGTTCTTCATCGATGC
96Leaf	CCACATGTAAAC	GCTGCGTTCTTCATCGATGC
97Leaf	TCGCCATATCAC	GCTGCGTTCTTCATCGATGC
98Leaf	GTGCCTTATCAC	GCTGCGTTCTTCATCGATGC
99Leaf	GGGCGCTATCAC	GCTGCGTTCTTCATCGATGC
100Leaf	CCGCATTATCAC	GCTGCGTTCTTCATCGATGC
101Leaf	AATGAGTATCAC	GCTGCGTTCTTCATCGATGC
102Leaf	ACTGGCTATCAC	GCTGCGTTCTTCATCGATGC
103Leaf	CACCTCTATCAC	GCTGCGTTCTTCATCGATGC
104Leaf	CGTGATTATCAC	GCTGCGTTCTTCATCGATGC
105Leaf	CACCTCTGCCCG	GCTGCGTTCTTCATCGATGC
106Leaf	TCGCCAAGTAGG	GCTGCGTTCTTCATCGATGC
107Leaf	GTGCCTTGCCCG	GCTGCGTTCTTCATCGATGC
108Leaf	GGGCGCTGCCCG	GCTGCGTTCTTCATCGATGC
109Leaf	TCGCCATCTTCT	GCTGCGTTCTTCATCGATGC
110Leaf	GTGCCTTCTTCT	GCTGCGTTCTTCATCGATGC
111Leaf	GGGCGCTCTTCT	GCTGCGTTCTTCATCGATGC
112.1Leaf	CCGCATTCTTCT	GCTGCGTTCTTCATCGATGC
112.2Leaf	CCGCATTGCCCG	GCTGCGTTCTTCATCGATGC
113.1Leaf	AATGAGTCTTCT	GCTGCGTTCTTCATCGATGC
113.2Leaf	AATGAGTGCCCG	GCTGCGTTCTTCATCGATGC
114Leaf	ACTGGCTCTTCT	GCTGCGTTCTTCATCGATGC
115Leaf	CACCTCTCTTCT	GCTGCGTTCTTCATCGATGC
116Leaf	CGTGATTCTTCT	GCTGCGTTCTTCATCGATGC
117Leaf	CGTGATAGTAGG	GCTGCGTTCTTCATCGATGC
118Leaf	CACCTCAGTAGG	GCTGCGTTCTTCATCGATGC
119Leaf	ACTGGCAGTAGG	GCTGCGTTCTTCATCGATGC
120Leaf	AATGAGAGTAGG	GCTGCGTTCTTCATCGATGC
121Leaf	TCGCCATTCCGT	GCTGCGTTCTTCATCGATGC
122Leaf	GTGCCTTTCCGT	GCTGCGTTCTTCATCGATGC
125Leaf	GGGCGCTTCCGT	GCTGCGTTCTTCATCGATGC
126.1Leaf	ACTGGCTGCCCG	GCTGCGTTCTTCATCGATGC
126.2Leaf	CCGCATTTCCGT	GCTGCGTTCTTCATCGATGC
127Leaf	AATGAGTTCCGT	GCTGCGTTCTTCATCGATGC
128Leaf	ACTGGCTTCCGT	GCTGCGTTCTTCATCGATGC
129Leaf	CACCTCTTCCGT	GCTGCGTTCTTCATCGATGC
130Leaf	CGTGATTTCCGT	GCTGCGTTCTTCATCGATGC
131Leaf	CCGCATAGTAGG	GCTGCGTTCTTCATCGATGC
132Leaf	GGGCGCAGTAGG	GCTGCGTTCTTCATCGATGC
133Leaf	GTGCCTAGTAGG	GCTGCGTTCTTCATCGATGC
NC.1Leaf	CGTGATAACTGA	GCTGCGTTCTTCATCGATGC
NC.2Leaf	CGTGATGGGGCG	GCTGCGTTCTTCATCGATGC
